%%%%%%%%%%%%%%%%%%%%%%%%%%%%%%%%%%%%%
%.      %  .   .    .  .          %.%
% .   .   %%%%% % %%% %%% %%%%%%% % %
%  . .  %  . .  % % . . %     % %   %
%%%%% %%%%% %%% % % % %%% %%%%% % %%%
%   % % % %   % % % %   % %     %   %
% %%% % % % %%% %%%%% %%% % %%% %%% %
%       %     %   %   %     % % %   %
%%% %%%%%%%%% %%%%%%% %%% %%% % % % %
% .  .  .  .  % .  .. % %   %     % %
% % %%%%% % %%% % % %%% % %%% %%% % %
% % %     % % % % %     %   % % % % %
% % % %%%%%%% % %%%%%%%%% %%% % %%% %
% % % %     %   % . . % ... % . % . %
%%% %%% % %%%%% %%%%% %%% %%% %%%%% %
%     % % ............  % %   % % % %
% % % % %  %. %%% %%% %%% % % % % % %
% % % % % %% .% % % % %   % % % ... %
% % %%%%%  %. %%% %%% % %%% %%% %%%%%
% .. .. %  % .% % % % % ....  % %   %
% %%% % %  %. %%% %%% %%%%%%%%% % %%%
%   % %  ...............  %   % %   %
% %%% %%%%%%%%%%%%%%%%%%%%% % % %%% %
% %  .....................  %       %
% % % %%%%% %%% % % % % %%%%%%%%%%%%%
% % %   %     % % % % ..... %   % % %
% % %%% %%% % % % %%%%%%%%% %%% % % %
% %   % %   % % %P  % %.. % % %     %
% %%% %%% %%% % %%% % % %%%%% % %%%%%
% ....  % . % . . % ..... %   % %   %
%%% % %%%%% %%%%% %%% %%% % %%% % %%%
% % % % % % % %     % %   % %   % % %
% % %%% % % % % %%%%%%%%% % % % % % %
%       %  .................  %     %
% %   % %%% %%% %%%%%%% %%% %%% %%% %
%.%   %       % ........  %     %  .%
%%%%%%%%%%%%%%%%%%%%%%%%%%%%%%%%%%%%%