%%%%%%%%%%%%%%%%%%%%%%
% %% . . . .% % .  . %
%    %%%%%% % %%%%%% %
%%%%%%.  . P .% . . .%
% .  % %%%%%% %% %%%%%
% %%%% %. . . . .%. .%
% . G . .%%% %%%. .% %
%%%%%%%%%%. . %%%%%% %
%.  . . . .%% . . . .%
%%%%%%%%%%%%%%%%%%%%%%