%%%%%%%%%%%%%%%%%%%%%%
% %% . . . .% % .  E %
%    %%%%%% % %%%%%% %
%%%%%%.  . P .% . . .%
% .  % %%%%%% %% %%%%%
% %%%% %. . . . .%. .%
% . E . .%%% %%%. .% %
%%%%%%%%%%. . %%%%%% %
%.  . . . .%% . . . .%
%%%%%%%%%%%%%%%%%%%%%%