%%%%%%%%%%%%%%%%%%%%
%.......%  G%......%
%.%%...%%  %%...%%.%
%.%..%........%..%.%
%.%%.%.%%%%%%.%.%%.%
%........P.........%
%%%%%%%%%%%%%%%%%%%%